S ./textures/pillar.xpm
	R 900 600

H ./textures/health.xpm


	NO ./textures/north.xpm
           SO ./textures/south.xpm
WE ./textures/west.xpm
EA 	./textures/east.xpm

		F	 255,0,0
   C 			  			0,255,0

11111111111
110000011111111111111
11S000000000000000001111111
1100000000000O000000111111
11000000000000B00000111111
11000000000000000000111111
10000000000000000000111
10000000011111111111
11111111111
