S ./textures/pillar.xpm
	R 900 600

H ./textures/health.xpm


	NO ./textures/north.xpm
           SO ./textures/south.xpm
WE ./textures/west.xpm
EA 	./textures/east.xpm

		F	 255,0,0
   C 			  			0,255,0

11111111111
11000001111
11S000001111
11000000111
11000000111
11000H00111
10000000111
10000000011
11111111111
