S ./textures/pillar.xpm
	R 900 600

H ./textures/health.xpm


	NO ./textures/north.xpm
           SO ./textures/south.xpm
WE ./textures/west.xpm
EA 	./textures/east.xpm

		F	 220,100,0
   C 			  			235,30,0

        11111111111 1111111111111
        10000000001 1000000000001
        10110000011 1000000000001
        1001000000111111100000001
111111111011000001001000000000001
100000000011111111111111111111111
111101111111        1111111
111101111111111111111001011
 1000000110101011100000010111
11000000000111001100000010001
10000000000000011101010000001
1100000111010101 111011110W01
11110111 1110101 101111010001
11111111 1111111 111111111111
