S ./textures/pillar.xpm
	R 900 600

H ./textures/health.xpm


	NO ./textures/north.xpm
           SO ./textures/south.xpm
WE ./textures/west.xpm
EA 	./textures/east.xpm

		F	 220,100,0
   C 			  			235,30,0

        11111111111 1111111111111
        10000000001 1000000000001
        10110000011 10000000000011111111111
        100100000011111110000000001
11111111100000000000000000000000111
10W000001111111111111101111011111
111101101           110111101
111101101           100000001
 10000101111 1111111101011111
111100000001110000000000000011111111111
 10000000000000111111111100001  1
1100000111010101 1 1 1  100111111
11110111 1110101 1 1 1  10001
11111111 1111111 111111111111
