S ./textures/pillar.xpm
	R 900 600

H ./textures/health.xpm


	NO ./textures/north.xpm
           SO ./textures/south.xpm
WE ./textures/west.xpm
EA 	./textures/east.xpm

		F	 255,0,0
   C 			  			0,255,0

11111111111111111111111111111111111
100000000001 10000000000000000111
11111111100111000011010000000000011
1       100000000011111110000000001
1111111110000000000000000000N000111
11000000000111111111101111011111111
111101101111        1001111011
1111011011          1000000011
110000101111111111111010111111
111100000001110000000000000011111
110000000000000111111111100001  1
1100000111010101 1 1 1  100111111
11110111 1110101 1 1 1  10001
11111111 1111111 111111111111

