S ./assets/textures/pillar.xpm
	R 900 600

H ./assets/textures/health.xpm


	NO ./assets/textures/north.xpm
           SO ./assets/textures/south.xpm
WE ./assets/textures/west.xpm
EA 	./assets/textures/east.xpm

		F	 255,0,0
   C 			  			0,255,0

        11111111111 111111111111
        10000000001 1000O00000001
        10110000011 10000000000011111111111
        100100000011111110000B00001
11111111100000000000000000000000111
11S000001111111111111101111011111
111101101           110111101
111101101           100000001
 10000101111 1111111101011111
11110000H001110000000R00000011111111111
 1000000B000000111111111100001  1
1100000111010101 1 1 1  100111111
11110111 1110101 1 1 1  10001
11111111 1111111 111111111111

