S ./textures/pillar.xpm
	R 900 600

H ./textures/health.xpm


	NO ./textures/north.xpm
           SO ./textures/south.xpm
WE ./textures/west.xpm
EA 	./textures/east.xpm

		F	 220,100,0
   C 			  			235,30,0

11111111111111111111
10000000000000000001
10000000000000000001
10000000000000000001
10000000000N00000001
10000000000000000001
11111111111111111111
