S ./textures/pillar.xpm
	R 900 600

H ./textures/health.xpm

	NO ./textures/north.xpm
           SO ./textures/south.xpm
WE ./textures/west.xpm
EA 	./textures/east.xpm

		F	 220,100,0
   C 			  			235,30,0

 1111111111111111111
100000111100000000001
1000001  100000011111
10000011110000001
10000000000N00011111
10000000011100000001
 111111111  1111111
